%%%%%%%%%%%%%%%%%%%%
%.            .%   %
%.%%.%%.%%.%%.%% % %
%        P       % %
%%%%%%%%%%%%%%%%%% %
%.                 %
%%%%%%%%%%%%%%%%%%%%
